111111111111111
AA22AA222A222AA
AA2A2A2AAA2AAAA
AA22AA222A222AA
111111111111111
