111111111111111
A111AAA111A111A
A1AA1AA1AAA1AAA
A111AAA111A111A
111111111111111