-00----2----3--
-0-0--2-2--3-3-
-0-0--2----3---
-0-0--2----3---
-0-0--2-2--3-3-
-00----2----3--
---777---777---
--77997-79977--
7779-97-79-9777
999---979---999
