131311131113331
131313331313331
131311331133331
131313331313131
111313331313111
