-5-1-2-3-4-0-5-
-5--1-2-3-4--5-
-5-0-1-2-3-4-5-
-5--0-1-2-3--5-
-5-4-0-1-2-3-5-
-5--4-0-1-2--5-
-5-3-4-0-1-2-5-
-5--3-4-0-1--5-
---------------
888888888888888
