-------5-------
-------5------0
------5-5----00
------5-5--0011
555555---501122
-----5---523322
-----5---5-4433
----5-----5--43
----5-----5---4
----5555555----
