737377737773337
737373337373337
737377337733337
737373337373737
777373337373777
