----00---------
---0000--------
---00002--2----
---00002222----
---03302222----
---33331221----
---33331111----
---3--31111----
-------1111----
--------11-----
