101011101110111
101010001010010
101011001100010
101010001010010
111010001010110
