565656565656565
656565656565656
57575757--57575
6565-565---5-56
5656---------65
---------------
---------9-----
---------------
---------------
------111------
