333335565533333
333365666563333
333365565563333
333366777663333
333366575663333
333665555566333
336665555566633
333335555533333
333336757633333
333337737733333
