111111111111111
A222AAA222A222A
A2AA2AA2AAA2AAA
A222AAA222A222A
111111111111111