-00----2----3--
-0-0--2-2--3-3-
-0-0--2----3---
-0-0--2----3---
-0-0--2-2--3-3-
-00----2----3--
---777---777---
--77977-77977--
7779-97779-9777
999---777---999
