-9-0-1-2-3-4-9-
-9--0-1-2-3--9-
-9-4-0-1-2-3-9-
-9--4-0-1-2--9-
-9-3-4-0-1-2-9-
-9--3-4-0-1--9-
-9-2-3-4-0-1-9-
-9--2-3-4-0--9-
---------------
888888888888888
