877777777777779
799999999999979
899999999999979
797777777777779
897999999999999
797999999999999
897777777777779
799999999999979
897777777777779
799999999999999
