55------0----55
5------0------5
5-------------5
5-----0-0-----5
5----00000----5
5----0000-----5
5----0000-----5
5----00000----5
5----00000----5
55----0-0----55
