----222--------
--2222222--22--
--22222122222--
--22111312222--
--21115331212--
--22213551122--
--22221311222--
--22222122222--
--22---222222--
---------22----
