999999999999999
888888888888888
777777777777777
666666666666666
000000000000000
111111111111111
222222222222222
333333333333333
444444444444444
555555555555555
