---------------
-------000-----
---00---0000---
----00-050060--
-----05050000--
----005005000--
---00-050500---
---------00----
--------00-----
-------0-------
